150s 3d
WWWWWWWWWWWWWW
WGGW.GDGG....W
WG.GGG.......W
WGB.BG...R...W
WG.GGGD......W
WGB.BG.......W
WGDGGD.......W
W.G.GG...E...W
WWWWWWWWWWWWWW