164s 0d
WWWWWWWWWWWWWW
WGGW.G.GG....W
WG.GGG.......W
WG..BG.......W
WGBGGG.......W
WGB.BG.......W
WGDGG........W
W.G.GG.R.S...W
WWWWWWWWWWWWWW
