149s 3d
WWWWWWWWWWWWWW
WGGGBG...R.GGW
WGGGG.GEG.G.GW
WGG.GDGGGG..GW
WG..GG.GGG.GGW
W.....G.GG.GGW
WBGDGBG...GGGW
WBGD.DGBBDGG.W
WWWWWWWWWWWWWW
