150s 4d
WWWWWWWWWWWWWW
WGGGBG.GGGRGGW
WGGGG.GEGDG.GW
WGG.GDGGGG..GW
WG.DGG.GGG.GGW
W.BD.BGBGG.GGW
W.G.G.GB.DGGGW
WBG..DG...GG.W
WWWWWWWWWWWWWW
